"filename", "language", "Dart", "comment", "blank", "total"
"g:\Local Disk F\Source Codes\Flutter\kurdbid\lib\admin_screen\home_screen.dart", "Dart", 100, 8, 5, 113
"g:\Local Disk F\Source Codes\Flutter\kurdbid\lib\admin_screen\item_pending_screen.dart", "Dart", 73, 1, 3, 77
"g:\Local Disk F\Source Codes\Flutter\kurdbid\lib\admin_screen\list_of_users.dart", "Dart", 66, 1, 3, 70
"g:\Local Disk F\Source Codes\Flutter\kurdbid\lib\admin_screen\single_item.dart", "Dart", 166, 51, 9, 226
"g:\Local Disk F\Source Codes\Flutter\kurdbid\lib\admin_screen\user_information_screen.dart", "Dart", 101, 32, 6, 139
"g:\Local Disk F\Source Codes\Flutter\kurdbid\lib\components\assets_path copy.dart", "Dart", 18, 0, 1, 19
"g:\Local Disk F\Source Codes\Flutter\kurdbid\lib\components\assets_path.dart", "Dart", 3, 14, 6, 23
"g:\Local Disk F\Source Codes\Flutter\kurdbid\lib\components\colors.dart", "Dart", 37, 0, 16, 53
"g:\Local Disk F\Source Codes\Flutter\kurdbid\lib\components\components_barrel.dart", "Dart", 9, 1, 2, 12
"g:\Local Disk F\Source Codes\Flutter\kurdbid\lib\components\icon_button.dart", "Dart", 15, 0, 3, 18
"g:\Local Disk F\Source Codes\Flutter\kurdbid\lib\components\image_card.dart", "Dart", 22, 19, 4, 45
"g:\Local Disk F\Source Codes\Flutter\kurdbid\lib\components\item_screen.dart", "Dart", 144, 0, 8, 152
"g:\Local Disk F\Source Codes\Flutter\kurdbid\lib\components\pick_image.dart", "Dart", 22, 0, 4, 26
"g:\Local Disk F\Source Codes\Flutter\kurdbid\lib\components\primary_button.dart", "Dart", 44, 0, 2, 46
"g:\Local Disk F\Source Codes\Flutter\kurdbid\lib\components\secondary_button.dart", "Dart", 14, 1, 2, 17
"g:\Local Disk F\Source Codes\Flutter\kurdbid\lib\components\snack_bar.dart", "Dart", 33, 5, 2, 40
"g:\Local Disk F\Source Codes\Flutter\kurdbid\lib\components\text.dart", "Dart", 21, 0, 2, 23
"g:\Local Disk F\Source Codes\Flutter\kurdbid\lib\components\textfield.dart", "Dart", 45, 5, 4, 54
"g:\Local Disk F\Source Codes\Flutter\kurdbid\lib\components\time_format.dart", "Dart", 15, 0, 2, 17
"g:\Local Disk F\Source Codes\Flutter\kurdbid\lib\components\url_launcher.dart", "Dart", 12, 3, 2, 17
"g:\Local Disk F\Source Codes\Flutter\kurdbid\lib\main.dart", "Dart", 333, 21, 28, 382
"g:\Local Disk F\Source Codes\Flutter\kurdbid\lib\navigation\navigator.dart", "Dart", 14, 0, 4, 18
"g:\Local Disk F\Source Codes\Flutter\kurdbid\lib\no_network.dart", "Dart", 118, 15, 16, 149
"g:\Local Disk F\Source Codes\Flutter\kurdbid\lib\providers\bottom_narbar_provider.dart", "Dart", 19, 0, 8, 27
"g:\Local Disk F\Source Codes\Flutter\kurdbid\lib\providers\network_providers.dart", "Dart", 21, 0, 3, 24
"g:\Local Disk F\Source Codes\Flutter\kurdbid\lib\providers\providers_barrel.dart", "Dart", 2, 2, 1, 5
"g:\Local Disk F\Source Codes\Flutter\kurdbid\lib\providers\theme_provider.dart", "Dart", 18, 0, 4, 22
"g:\Local Disk F\Source Codes\Flutter\kurdbid\lib\public_packages.dart", "Dart", 6, 1, 2, 9
"g:\Local Disk F\Source Codes\Flutter\kurdbid\lib\shared_preferences\screens_state_manager.dart", "Dart", 13, 4, 6, 23
"g:\Local Disk F\Source Codes\Flutter\kurdbid\lib\shared_preferences\shared_pref_barrel.dart", "Dart", 2, 0, 1, 3
"g:\Local Disk F\Source Codes\Flutter\kurdbid\lib\shared_preferences\theme_shared_preferences.dart", "Dart", 12, 0, 4, 16
"g:\Local Disk F\Source Codes\Flutter\kurdbid\lib\theme\theme_style.dart", "Dart", 37, 63, 4, 104
"g:\Local Disk F\Source Codes\Flutter\kurdbid\lib\user_screens\add_item.dart", "Dart", 276, 74, 19, 369
"g:\Local Disk F\Source Codes\Flutter\kurdbid\lib\user_screens\category.dart", "Dart", 103, 8, 5, 116
"g:\Local Disk F\Source Codes\Flutter\kurdbid\lib\user_screens\home_screen.dart", "Dart", 121, 6, 6, 133
"g:\Local Disk F\Source Codes\Flutter\kurdbid\lib\user_screens\login_screen.dart", "Dart", 155, 63, 21, 239
"g:\Local Disk F\Source Codes\Flutter\kurdbid\lib\user_screens\otp_verification_screen.dart", "Dart", 162, 100, 17, 279
"g:\Local Disk F\Source Codes\Flutter\kurdbid\lib\user_screens\profile_screen..dart", "Dart", 74, 2, 6, 82
"g:\Local Disk F\Source Codes\Flutter\kurdbid\lib\user_screens\screen_tobe_shown.dart", "Dart", 11, 9, 4, 24
"g:\Local Disk F\Source Codes\Flutter\kurdbid\lib\user_screens\screens_barrel.dart", "Dart", 6, 5, 1, 12
"g:\Local Disk F\Source Codes\Flutter\kurdbid\lib\user_screens\settings.dart", "Dart", 58, 0, 5, 63
"g:\Local Disk F\Source Codes\Flutter\kurdbid\lib\user_screens\terms_and_condition.dart", "Dart", 49, 0, 3, 52
"g:\Local Disk F\Source Codes\Flutter\kurdbid\lib\user_screens\user_information_screen.dart", "Dart", 283, 74, 17, 374
"Total", "-", 2853, 588, 271, 3712